4	19	20	19	5	5	5	5	5	5	5	
6	6	6	6	6	6	6	6	6	6	5	
5	5	23	3	5	6	52	5	5	6	5	
52	23	5	6	5	6	53	5	5	6	5	
6	3	6	6	5	6	6	6	5	6	5	
5	53	5	6	5	3	22	25	22	6	5	
5	24	5	6	5	6	6	6	6	6	5	
6	3	6	6	5	5	5	5	5	5	5	
5	24	5	6	6	7	6	6	6	3	6	
57	58	57	6	54	5	5	6	5	26	5	
57	59	57	6	5	78	5	6	5	5	5	
