5	6	6	5	5	6	5	5	6	6	5	
5	5	6	6	3	6	3	6	6	5	5	
5	5	5	5	5	6	5	5	5	5	5	
5	6	5	6	6	6	6	6	5	6	6	
5	6	5	5	5	5	5	5	5	6	5	
5	6	5	6	6	6	6	3	6	6	5	
5	6	5	10	5	78	6	5	3	5	5	
5	6	6	6	6	6	6	3	6	6	5	
5	6	5	5	5	6	5	5	5	6	5	
5	6	5	5	5	7	5	6	5	6	5	
4	6	5	5	5	6	5	6	5	6	5	
