5	6	5	6	5	6	5	6	5	5	5	
5	6	5	6	5	6	5	6	5	5	5	
5	6	5	6	5	6	5	6	5	5	5	
3	6	3	6	3	6	3	6	6	8	6	
5	5	5	5	5	6	5	5	5	5	5	
3	6	6	8	6	6	6	8	6	6	3	
5	6	5	5	5	5	5	5	5	6	5	
5	6	5	6	6	6	6	6	5	6	5	
5	6	5	6	5	5	5	6	5	6	5	
6	6	7	6	5	5	5	6	7	6	6	
78	5	5	5	5	5	5	5	5	5	4	
