5	5	5	5	5	5	5	6	5	5	5	
5	6	6	6	6	6	3	6	5	6	5	
5	6	5	5	5	5	5	6	5	6	5	
5	6	7	6	6	6	5	6	5	6	5	
5	6	5	5	5	6	5	6	5	6	5	
5	6	5	5	10	6	5	6	5	6	5	
5	6	5	10	5	6	5	6	5	6	5	
5	6	6	6	6	6	5	6	5	6	5	
5	5	5	6	5	5	5	5	5	6	5	
6	6	5	6	5	6	6	6	6	6	5	
78	5	5	8	5	4	6	5	5	3	5	
