6	5	5	5	4	5	5	5	5	5	6	
6	5	5	6	6	6	6	6	5	5	6	
6	5	6	6	6	6	6	6	6	5	6	
6	5	6	6	6	5	6	6	6	5	6	
6	5	6	6	6	10	6	6	6	5	6	
6	5	5	6	6	5	6	6	5	5	6	
6	5	2	2	6	5	6	2	2	5	6	
6	5	2	2	6	5	6	2	2	5	6	
6	5	2	2	6	8	6	2	2	5	6	
6	5	5	5	8	5	8	5	5	5	6	
6	6	6	6	6	78	6	6	6	6	6	
