5	5	5	5	78	2	4	5	5	5	5	
5	2	2	2	2	2	2	2	2	2	5	
5	2	2	6	6	6	6	6	2	2	5	
5	2	6	6	5	6	5	6	6	2	5	
5	2	6	6	5	6	5	6	6	2	5	
5	2	6	6	5	6	5	6	6	2	5	
5	2	2	6	5	6	5	6	2	2	5	
5	2	2	6	3	6	3	6	2	2	5	
5	2	2	2	5	5	5	2	2	2	5	
5	2	2	2	2	7	2	2	2	2	5	
5	5	5	5	5	5	5	5	5	5	5	
