2	2	2	2	2	5	78	2	2	2	2	
2	2	2	2	2	5	2	2	2	2	2	
2	2	2	2	2	5	2	2	2	2	2	
2	2	2	2	6	7	6	2	2	2	2	
2	2	2	6	6	5	6	6	2	2	2	
2	2	2	6	6	5	6	6	2	2	2	
2	2	2	6	6	5	6	6	2	2	2	
2	2	2	6	6	5	6	6	2	2	2	
2	2	2	6	6	4	6	6	2	2	2	
2	2	2	2	6	6	6	2	2	2	2	
2	2	2	2	2	2	2	2	2	2	2	
