2	5	5	5	5	5	5	5	5	5	5	
2	5	2	2	2	2	2	2	2	2	5	
2	5	2	5	5	5	5	5	5	5	5	
2	5	2	5	2	2	2	2	2	2	2	
2	5	2	5	2	5	5	5	5	5	2	
2	5	2	5	5	5	2	2	2	5	2	
2	5	2	2	2	2	2	5	5	5	2	
2	5	2	2	2	78	2	5	2	2	2	
2	5	5	5	5	5	2	5	5	5	5	
2	2	2	2	2	2	2	2	2	2	5	
4	5	5	5	5	5	5	5	5	5	5	
