2	2	2	2	2	2	2	2	2	2	2	
2	2	2	2	2	2	2	2	2	2	2	
2	2	2	2	2	2	2	2	2	2	2	
2	2	2	2	6	6	6	2	2	2	2	
2	2	2	6	6	5	6	6	2	2	2	
2	2	2	6	6	10	6	6	2	2	2	
2	2	2	6	6	7	6	6	2	2	2	
2	2	2	2	6	7	6	2	2	2	2	
2	2	2	2	2	2	2	2	2	2	2	
2	2	2	2	2	2	2	2	2	2	2	
78	5	5	5	5	5	5	5	5	5	5	
