5	5	5	5	5	5	5	5	5	5	5	
5	2	5	2	2	2	2	2	5	2	5	
5	2	5	2	2	2	2	2	5	2	5	
5	2	5	2	2	4	2	2	5	2	5	
5	2	5	2	2	5	2	2	5	2	5	
5	2	5	2	2	5	2	2	5	2	5	
5	2	10	2	2	5	2	2	10	2	5	
5	2	5	2	2	5	2	2	5	2	5	
5	2	2	2	2	5	2	2	2	2	5	
5	2	2	2	2	5	2	2	2	2	5	
5	5	5	5	5	5	5	5	5	5	78	
