5	5	5	5	5	5	5	5	5	5	5	
5	2	5	2	5	2	5	2	5	2	5	
2	5	5	5	5	5	5	5	5	5	2	
5	2	5	2	5	78	5	2	5	2	5	
5	5	5	5	5	5	5	5	5	5	5	
5	2	5	2	5	2	5	2	5	2	5	
5	5	5	5	5	5	5	5	5	5	5	
5	2	5	2	5	4	5	2	5	2	5	
2	5	5	5	5	5	5	5	5	5	2	
5	2	5	2	5	2	5	2	5	2	5	
5	5	5	5	5	5	5	5	5	5	5	
