5	5	5	6	5	5	5	6	6	6	6	
5	5	5	6	5	5	5	6	5	5	5	
5	5	5	6	6	3	6	6	5	6	5	
6	3	6	6	5	5	5	6	5	6	5	
5	5	5	6	6	6	5	6	5	6	5	
5	6	5	5	5	5	5	6	5	6	5	
5	6	6	6	6	6	5	5	5	6	5	
5	5	5	5	5	6	6	3	6	6	5	
6	6	6	6	5	6	5	5	5	6	5	
6	5	5	5	5	6	5	5	5	6	5	
78	5	6	6	6	6	5	5	5	6	4	
