5	5	5	6	5	5	5	6	5	5	5	
3	6	3	6	5	5	5	6	3	6	3	
5	6	5	6	6	10	6	6	5	6	5	
5	6	5	6	5	5	5	6	5	6	5	
5	6	5	6	5	5	5	6	5	6	5	
5	6	5	6	6	7	6	6	5	6	5	
5	6	5	6	5	5	5	6	5	6	5	
5	6	5	6	5	5	5	6	5	6	5	
5	6	5	6	6	8	6	6	5	6	5	
5	6	5	6	5	5	5	6	5	6	5	
4	6	5	5	5	5	5	5	5	6	78	
