4	5	5	5	5	5	5	5	6	6	6	
6	6	5	5	6	8	6	5	5	6	6	
6	5	5	5	6	5	6	5	5	5	6	
5	5	6	6	6	10	6	6	6	5	5	
5	5	8	5	10	5	10	5	8	5	5	
5	6	6	6	6	10	6	6	6	6	5	
5	6	5	5	6	5	6	5	5	6	5	
5	6	5	5	6	8	6	5	5	6	5	
5	6	6	5	5	5	5	5	6	6	5	
5	5	6	6	6	7	6	6	6	5	5	
6	5	5	3	78	5	5	5	5	5	6	
