78	6	5	5	5	5	6	5	5	5	5	
5	6	5	6	6	3	6	3	6	6	5	
5	6	5	6	5	5	8	5	5	6	5	
5	6	5	6	5	6	6	6	5	6	5	
5	6	5	6	5	6	4	5	5	6	5	
5	6	5	6	5	6	6	6	6	6	5	
5	6	5	6	5	5	5	6	5	5	5	
5	6	5	6	6	6	5	6	3	6	6	
5	6	5	5	5	6	5	6	5	5	5	
5	6	6	6	3	6	5	6	6	6	5	
5	5	5	5	5	6	5	5	5	5	5	
