5	5	5	6	6	6	5	5	5	6	5	
5	5	5	3	5	5	5	6	5	3	5	
6	3	6	6	5	6	6	6	5	6	5	
5	5	5	6	5	6	5	5	5	6	5	
5	5	5	7	5	6	78	6	5	6	5	
6	8	6	6	5	6	6	6	5	6	6	
5	5	5	6	5	6	4	6	5	6	5	
6	3	6	6	5	5	5	3	5	6	5	
5	5	5	6	6	8	6	6	5	6	5	
5	5	5	6	5	5	5	6	5	3	5	
5	5	5	3	5	5	5	6	5	6	5	
